<xex>	example, marks example words/phrases in definitions<br>ç¤ºä¾‹ï¼Œåœ¨å®šä¹‰ä¸­æ ‡è®°ç¤ºä¾‹è¯è¯­æˆ–çŸ­è¯­
<nbsp/	non-breaking space<br>å†…è”ç©ºæ ¼
<or/	or<br>æˆ–
<and/	and<br>å’Œ
<bar/	horizontal bar<br>æ¨ªæ¡
<colbreak/	column break<br>åˆ†æ 
<colret/	column return<br>åˆ—å›è½¦
<downslur/	down slur<br>ä¸‹é™è¿éŸ³çº¿
<upslur/	up slur<br>ä¸Šå‡è¿éŸ³çº¿
<dele/	delete<br>åˆ é™¤ç¬¦å·
<asterism/	â‚<br>asterism<br>ä¸‰æ˜Ÿæ ‡
<dagger/	â€ <br>dagger<br>å‰‘æ ‡
<iques/	Â¿<br>inverted question mark<br>å€’é—®å·
<mdash/	â€”<br>em dash<br>é•¿ç ´æŠ˜å·
<para/	Â¶<br>pilcrow<br>æ®µè½ç¬¦
<ai/	aÉª<br>ai diphthong sound<br>åŒå…ƒéŸ³ai
<ait/	áº­<br>a circumflex with dot underneath<br>å¸¦æ‰¬æŠ‘ç¬¦å’Œä¸‹ç‚¹ç¬¦çš„a
<eit/	á»‡<br>e circumflex with dot underneath<br>å¸¦æ‰¬æŠ‘ç¬¦å’Œä¸‹ç‚¹ç¬¦çš„e
<etil/	áº½<br>e with tilde above<br>å¸¦æ³¢æµªç¬¦çš„e
<hsdot/	á¸¥<br>h with dot underneath<br>å¸¦ä¸‹ç‚¹ç¬¦çš„h
<lsdot/	á¸·<br>l with dot underneath<br>å¸¦ä¸‹ç‚¹ç¬¦çš„l
<mdot/	á¹ƒ<br>m with dot underneath<br>å¸¦ä¸‹ç‚¹ç¬¦çš„m
<msdot/	á¹ƒ<br>m with dot underneath<br>å¸¦ä¸‹ç‚¹ç¬¦çš„m
<ncir/	nÌ‚<br>n circumflex<br>å¸¦æ‰¬æŠ‘ç¬¦çš„n
<oocr/	ÅÅ<br>oo with crescent above<br>å¸¦çŸ­éŸ³ç¬¦çš„oo
<oomac/	ÅÅ<br>oo with macron<br>å¸¦é•¿éŸ³ç¬¦çš„oo
<udd/	ÊŒ<br>open-mid back unrounded vowel<br>ä¸­å¼€åä¸åœ†å”‡å…ƒéŸ³
<usdot/	á»¥<br>u with dot underneath<br>å¸¦ä¸‹ç‚¹ç¬¦çš„u
<ycr/	yÌ†<br>y with crescent above<br>å¸¦çŸ­éŸ³ç¬¦çš„y
<zdot/	Å¼<br>z with dot above<br>å¸¦ç‚¹çš„z
<zsdot/	áº•<br>z with dot underneath<br>å¸¦ä¸‹ç‚¹ç¬¦çš„z
<schwa/	É™<br>schwa<br>ä¸­å¤®å…ƒéŸ³
<cacute/	Ä‡<br>c with acute accent<br>å¸¦å°–éŸ³ç¬¦çš„c
<ccar/	Ä<br>c with caron<br>å¸¦æŠ‘æ‰¬ç¬¦çš„c
<csdot/	cÌ£<br>c with dot underneath<br>å¸¦ä¸‹ç‚¹ç¬¦çš„c
<add/	â€¿<br>add<br>æ·»åŠ ã€‚è¡¨ç¤ºè¿è¯»
<asper/	á¿¾<br>spiritus asper<br>ç²—ç³™æ°”æ¯
<breve/	Ë˜<br>breve accent<br>çŸ­éŸ³ç¬¦
<umlaut/	Â¨<br>dieresis<br>åˆ†éŸ³ç¬¦
<ffllig/	ï¬€<br>ff ligature<br>ffè¿å­—
<filig/	ï¬<br>fi ligature<br>fiè¿å­—
<fllig/	ï¬‚<br>fl ligature<br>flè¿å­—
<crev/	â†ƒ<br>Roman numeral reversed C, meaning 200<br>å¤ç½—é©¬æ•°å­—å˜ä½“å€’ç½®Cï¼Œè¡¨ç¤º200
<digamma/	Ï<br>digamma<br>å¤å¸Œè…Šå­—æ¯è¿ªä¼½ç›
<sigmat/	Ï‚<br>sigmate<br>è¯å°¾å½¢å¼çš„è¥¿æ ¼é©¬
<dot/	.<br>dot<br>ç‚¹ç¬¦å·
<gt/	><br>greater than<br>å¤§äº
<lt/	<<br>less than<br>å°äº
<lbrace2/	{<br>left curly brace<br>å·¦å¤§æ‹¬å·
<rbrace2/	}<br>right curly brace<br>å³å¤§æ‹¬å·
<cuberoot/	âˆ›<br>cube root<br>ç«‹æ–¹æ ¹
<integral2l/	âˆ«<br>integration<br>ç§¯åˆ†
<min/	'<br>minute of arc<br>è§’åˆ†
<nabla/	âˆ‡<br>nabla<br>å‘é‡å¾®åˆ†ç®—å­
<times/	Ã—<br>times<br>ä¹˜å·
<ounceap/	â„¥<br>apothecaries' ounce<br>è¯è¡¡ç›å¸
<natural/	â™®<br>natural sign<br>è¿˜åŸå·
<pause/	ğ„<br>pause<br>å»¶é•¿è®°å·
<rarr/	â†’<br>right arrow<br>å³ç®­å¤´
<leo/	â™Œ<br>leo zodiac sign<br>ç‹®å­åº§ç¬¦å·
<libra/	â™<br>libra zodiac sign<br>å¤©ç§¤åº§ç¬¦å·
<pisces/	â™“<br>pisces zodiac sign<br>åŒé±¼åº§ç¬¦å·
<sagittarius/	â™<br>sagittarius zodiac sign<br>å°„æ‰‹åº§ç¬¦å·
<scorpio/	â™<br>scorpio zodiac sign<br>å¤©èåº§ç¬¦å·
<taurus/	â™‰<br>taurus zodiac sign<br>é‡‘ç‰›åº§ç¬¦å·
<virgo/	â™<br>virgo zodiac sign<br>å¤„å¥³åº§ç¬¦å·
<aquarius/	â™’<br>aquarius zodiac sign<br>æ°´ç“¶åº§ç¬¦å·
<aries/	â™ˆ<br>aries zodiac sign<br>ç™½ç¾Šåº§ç¬¦å·
<cancer/	â™‹<br>cancer zodiac sign<br>å·¨èŸ¹åº§ç¬¦å·
<capricorn/	â™‘<br>capricorn zodiac sign<br>æ‘©ç¾¯åº§ç¬¦å·
<sun/	â˜‰<br>sun<br>å¤ªé˜³
<jupiter/	â™ƒ<br>jupiter<br>æœ¨æ˜Ÿ
<mercury/	â˜¿<br>mercury<br>æ°´æ˜Ÿ
<male/	â™‚<br>male<br>é›„æ€§
<astascending/	â˜Š<br>ascending node<br>å‡äº¤ç‚¹
<astdescending/	â˜‹<br>descending node<br>é™äº¤ç‚¹
